1111111111111111111111111111111111
1C000000000000000000000000000P00C1
1100011100100000101001000C00010101
1001110010101010001001000100010101
110000000C0C0000000010000000000C11
1111111111111101111111111111111111
1000000000000C0C000000000000000001
10M000000000000C00000C000000000001
1110011100100000101001000C00010101
11E0111001010101000100100010001101
111C000000C0C0000000010000000000C1
1111111111111111111111111111111111